111111111111111
100000000000001
101110111111101
100010000000101
101010101111101
101000100000101
101110111111101
100000000000101
101011111110101
101000000010001
111111111111111
